555888888888888888555555555
589               788885555
6/  E D E D        S   7885
[3P /  /  /        R      4
5[22222222223        R    4
555555558555[222223    R  4
55885556S4558888889       4
56  7889 789          1222]
59           D  D     78555
6          E      E    S455
6 DG        EEEEEE      755
6D X                     45
6 DX          122223     75
6D      13    458856/R    4
6/      46////46  4[23    4
[223    4[2222]6M 4556/R  4
5556////4555555[22]55[23/K4
555[2222]55555555555555[22]